PNNNSNSNNNNSP
NMNMNMSMNMNMN
NNNNNNNSNNSSN
SMSMNMNMNMNMS
NNNNSNSNNSNNN
NMNMNMNMNMNMN
SSNNNNNNNNSNN
NMSMNMSMSMSMN
SNNSSNNNNSSNN
NMSMSMNMNMNMS
PNNSNNNNNSNNS