PNNSNNSSSSNSP
SMNMNMSMNMNMN
NNNSSSNSNNSSN
SMSMNMSMNMSMS
NNNNSNSNNSNSN
NMNMNMNMNMNMN
NNNNSSSNNNSNS
NMSMSMSMSMSMS
NNNSSNSSNSSNS
NMSMSMNMSMNMS
PNNSNNNNNSNNS